{
  "schemaVersion": 1,
  "levels": [
    {
      "name": "Sky Climb",

      "gravity": 0.45,
      "jumpV": -15.5,

      "world": {
        "w": 800,
        "h": 3600,
        "deathY": 3800
      },

      "start": { "x": 400, "y": 3400, "r": 26 },

      "door": { "x": 400, "y": 200 },

      "platforms": [
        { "x": 320, "y": 3400, "w": 200, "h": 16 },
        { "x": 240, "y": 3280, "w": 200, "h": 16 },
        { "x": 420, "y": 3160, "w": 200, "h": 16 },
        { "x": 300, "y": 3040, "w": 200, "h": 16 },
        { "x": 240, "y": 2920, "w": 200, "h": 16 },
        { "x": 420, "y": 2800, "w": 200, "h": 16 },
        { "x": 300, "y": 2680, "w": 200, "h": 16 },
        { "x": 240, "y": 2560, "w": 200, "h": 16 },
        { "x": 420, "y": 2440, "w": 200, "h": 16 },
        { "x": 300, "y": 2320, "w": 200, "h": 16 },

        { "x": 260, "y": 2200, "w": 200, "h": 16 },
        { "x": 420, "y": 2080, "w": 200, "h": 16 },
        { "x": 300, "y": 1960, "w": 200, "h": 16 },
        { "x": 240, "y": 1840, "w": 200, "h": 16 },
        { "x": 420, "y": 1720, "w": 200, "h": 16 },
        { "x": 300, "y": 1600, "w": 200, "h": 16 },
        { "x": 240, "y": 1480, "w": 200, "h": 16 },
        { "x": 420, "y": 1360, "w": 200, "h": 16 },
        { "x": 300, "y": 1240, "w": 200, "h": 16 },

        { "x": 300, "y": 1120, "w": 200, "h": 16 },
        { "x": 200, "y": 1000, "w": 200, "h": 16 },
        { "x": 400, "y": 880, "w": 200, "h": 16 },
        { "x": 250, "y": 760, "w": 200, "h": 16 },
        { "x": 350, "y": 640, "w": 200, "h": 16 },
        { "x": 220, "y": 520, "w": 200, "h": 16 },
        { "x": 380, "y": 400, "w": 200, "h": 16 }
      ]
    }
  ]
}
